LastStatisticsDate,StatisticsDate,DailyCases,TotalCases,TotalCasesLast14D,PerPopulation
2023-01-23,2020-02-26,1,1,1,0.08
2023-01-23,2020-02-27,0,1,1,0.08
2023-01-23,2020-02-28,0,1,1,0.08
2023-01-23,2020-02-29,0,1,1,0.08
2023-01-23,2020-03-01,0,1,1,0.08
2023-01-23,2020-03-02,1,2,2,0.15
2023-01-23,2020-03-03,0,2,2,0.15
2023-01-23,2020-03-04,1,3,3,0.23
2023-01-23,2020-03-05,7,10,10,0.75
2023-01-23,2020-03-06,0,10,10,0.75
2023-01-23,2020-03-07,0,10,10,0.75
2023-01-23,2020-03-08,0,10,10,0.75
2023-01-23,2020-03-09,3,13,13,0.98
2023-01-23,2020-03-10,2,15,15,1.13
2023-01-23,2020-03-11,3,18,17,1.28
2023-01-23,2020-03-12,40,58,57,4.29
2023-01-23,2020-03-13,43,101,100,7.52
2023-01-23,2020-03-14,23,124,123,9.26
2023-01-23,2020-03-15,75,199,198,14.9
2023-01-23,2020-03-16,25,224,222,16.7
2023-01-23,2020-03-17,22,246,244,18.36
2023-01-23,2020-03-18,28,274,271,20.39
2023-01-23,2020-03-19,28,302,292,21.97
2023-01-23,2020-03-20,13,315,305,22.95
2023-01-23,2020-03-21,41,356,346,26.04
2023-01-23,2020-03-22,13,369,359,27.01
2023-01-23,2020-03-23,24,393,380,28.59
2023-01-23,2020-03-24,74,467,452,34.01
2023-01-23,2020-03-25,55,522,504,37.92
2023-01-23,2020-03-26,37,559,501,37.7
2023-01-23,2020-03-27,64,623,522,39.28
2023-01-23,2020-03-28,40,663,539,40.56
2023-01-23,2020-03-29,32,695,496,37.32
2023-01-23,2020-03-30,31,726,502,37.77
2023-01-23,2020-03-31,57,783,537,40.41
2023-01-23,2020-04-01,79,862,588,44.24
2023-01-23,2020-04-02,93,955,653,49.14
2023-01-23,2020-04-03,74,1029,714,53.73
2023-01-23,2020-04-04,63,1092,736,55.38
2023-01-23,2020-04-05,11,1103,734,55.23
2023-01-23,2020-04-06,42,1145,752,56.58
2023-01-23,2020-04-07,36,1181,714,53.73
2023-01-23,2020-04-08,23,1204,682,51.32
2023-01-23,2020-04-09,51,1255,696,52.37
2023-01-23,2020-04-10,46,1301,678,51.02
2023-01-23,2020-04-11,5,1306,643,48.38
2023-01-23,2020-04-12,17,1323,628,47.25
2023-01-23,2020-04-13,45,1368,642,48.31
2023-01-23,2020-04-14,27,1395,612,46.05
2023-01-23,2020-04-15,34,1429,567,42.66
2023-01-23,2020-04-16,25,1454,499,37.55
2023-01-23,2020-04-17,53,1507,478,35.97
2023-01-23,2020-04-18,16,1523,431,32.43
2023-01-23,2020-04-19,7,1530,427,32.13
2023-01-23,2020-04-20,17,1547,402,30.25
2023-01-23,2020-04-21,7,1554,373,28.07
2023-01-23,2020-04-22,33,1587,383,28.82
2023-01-23,2020-04-23,14,1601,346,26.04
2023-01-23,2020-04-24,29,1630,329,24.76
2023-01-23,2020-04-25,9,1639,333,25.06
2023-01-23,2020-04-26,4,1643,320,24.08
2023-01-23,2020-04-27,10,1653,285,21.45
2023-01-23,2020-04-28,9,1662,267,20.09
2023-01-23,2020-04-29,23,1685,256,19.26
2023-01-23,2020-04-30,5,1690,236,17.76
2023-01-23,2020-05-01,5,1695,188,14.15
2023-01-23,2020-05-02,1,1696,173,13.02
2023-01-23,2020-05-03,3,1699,169,12.72
2023-01-23,2020-05-04,8,1707,160,12.04
2023-01-23,2020-05-05,2,1709,155,11.66
2023-01-23,2020-05-06,7,1716,129,9.71
2023-01-23,2020-05-07,5,1721,120,9.03
2023-01-23,2020-05-08,8,1729,99,7.45
2023-01-23,2020-05-09,6,1735,96,7.22
2023-01-23,2020-05-10,2,1737,94,7.07
2023-01-23,2020-05-11,5,1742,89,6.7
2023-01-23,2020-05-12,6,1748,86,6.47
2023-01-23,2020-05-13,7,1755,70,5.27
2023-01-23,2020-05-14,8,1763,73,5.49
2023-01-23,2020-05-15,4,1767,72,5.42
2023-01-23,2020-05-16,4,1771,75,5.64
2023-01-23,2020-05-17,10,1781,82,6.17
2023-01-23,2020-05-18,6,1787,80,6.02
2023-01-23,2020-05-19,4,1791,82,6.17
2023-01-23,2020-05-20,6,1797,81,6.09
2023-01-23,2020-05-21,7,1804,83,6.25
2023-01-23,2020-05-22,14,1818,89,6.7
2023-01-23,2020-05-23,2,1820,85,6.4
2023-01-23,2020-05-24,1,1821,84,6.32
2023-01-23,2020-05-25,10,1831,89,6.7
2023-01-23,2020-05-26,6,1837,89,6.7
2023-01-23,2020-05-27,11,1848,93,7
2023-01-23,2020-05-28,9,1857,94,7.07
2023-01-23,2020-05-29,6,1863,96,7.22
2023-01-23,2020-05-30,4,1867,96,7.22
2023-01-23,2020-05-31,2,1869,88,6.62
2023-01-23,2020-06-01,0,1869,82,6.17
2023-01-23,2020-06-02,10,1879,88,6.62
2023-01-23,2020-06-03,10,1889,92,6.92
2023-01-23,2020-06-04,21,1910,106,7.98
2023-01-23,2020-06-05,22,1932,114,8.58
2023-01-23,2020-06-06,7,1939,119,8.95
2023-01-23,2020-06-07,1,1940,119,8.95
2023-01-23,2020-06-08,7,1947,116,8.73
2023-01-23,2020-06-09,11,1958,121,9.1
2023-01-23,2020-06-10,7,1965,117,8.8
2023-01-23,2020-06-11,6,1971,114,8.58
2023-01-23,2020-06-12,5,1976,113,8.5
2023-01-23,2020-06-13,0,1976,109,8.2
2023-01-23,2020-06-14,0,1976,107,8.05
2023-01-23,2020-06-15,0,1976,107,8.05
2023-01-23,2020-06-16,3,1979,100,7.52
2023-01-23,2020-06-17,1,1980,91,6.85
2023-01-23,2020-06-18,3,1983,73,5.49
2023-01-23,2020-06-19,4,1987,55,4.14
2023-01-23,2020-06-20,0,1987,48,3.61
2023-01-23,2020-06-21,0,1987,47,3.54
2023-01-23,2020-06-22,1,1988,41,3.09
2023-01-23,2020-06-23,1,1989,31,2.33
2023-01-23,2020-06-24,1,1990,25,1.88
2023-01-23,2020-06-25,2,1992,21,1.58
2023-01-23,2020-06-26,1,1993,17,1.28
2023-01-23,2020-06-27,1,1994,18,1.35
2023-01-23,2020-06-28,0,1994,18,1.35
2023-01-23,2020-06-29,2,1996,20,1.5
2023-01-23,2020-06-30,0,1996,17,1.28
2023-01-23,2020-07-01,1,1997,17,1.28
2023-01-23,2020-07-02,1,1998,15,1.13
2023-01-23,2020-07-03,2,2000,13,0.98
2023-01-23,2020-07-04,0,2000,13,0.98
2023-01-23,2020-07-05,1,2001,14,1.05
2023-01-23,2020-07-06,1,2002,14,1.05
2023-01-23,2020-07-07,9,2011,22,1.66
2023-01-23,2020-07-08,8,2019,29,2.18
2023-01-23,2020-07-09,2,2021,29,2.18
2023-01-23,2020-07-10,1,2022,29,2.18
2023-01-23,2020-07-11,0,2022,28,2.11
2023-01-23,2020-07-12,0,2022,28,2.11
2023-01-23,2020-07-13,1,2023,27,2.03
2023-01-23,2020-07-14,1,2024,28,2.11
2023-01-23,2020-07-15,0,2024,27,2.03
2023-01-23,2020-07-16,4,2028,30,2.26
2023-01-23,2020-07-17,1,2029,29,2.18
2023-01-23,2020-07-18,0,2029,29,2.18
2023-01-23,2020-07-19,0,2029,28,2.11
2023-01-23,2020-07-20,1,2030,28,2.11
2023-01-23,2020-07-21,3,2033,22,1.66
2023-01-23,2020-07-22,2,2035,16,1.2
2023-01-23,2020-07-23,1,2036,15,1.13
2023-01-23,2020-07-24,3,2039,17,1.28
2023-01-23,2020-07-25,1,2040,18,1.35
2023-01-23,2020-07-26,0,2040,18,1.35
2023-01-23,2020-07-27,4,2044,21,1.58
2023-01-23,2020-07-28,4,2048,24,1.81
2023-01-23,2020-07-29,9,2057,33,2.48
2023-01-23,2020-07-30,13,2070,42,3.16
2023-01-23,2020-07-31,8,2078,49,3.69
2023-01-23,2020-08-01,7,2085,56,4.21
2023-01-23,2020-08-02,1,2086,57,4.29
2023-01-23,2020-08-03,11,2097,67,5.04
2023-01-23,2020-08-04,22,2119,86,6.47
2023-01-23,2020-08-05,11,2130,95,7.15
2023-01-23,2020-08-06,9,2139,103,7.75
2023-01-23,2020-08-07,14,2153,114,8.58
2023-01-23,2020-08-08,4,2157,117,8.8
2023-01-23,2020-08-09,6,2163,123,9.26
2023-01-23,2020-08-10,9,2172,128,9.63
2023-01-23,2020-08-11,7,2179,131,9.86
2023-01-23,2020-08-12,0,2179,122,9.18
2023-01-23,2020-08-13,3,2182,112,8.43
2023-01-23,2020-08-14,7,2189,111,8.35
2023-01-23,2020-08-15,6,2195,110,8.28
2023-01-23,2020-08-16,2,2197,111,8.35
2023-01-23,2020-08-17,8,2205,108,8.13
2023-01-23,2020-08-18,7,2212,93,7
2023-01-23,2020-08-19,20,2232,102,7.68
2023-01-23,2020-08-20,17,2249,110,8.28
2023-01-23,2020-08-21,21,2270,117,8.8
2023-01-23,2020-08-22,7,2277,120,9.03
2023-01-23,2020-08-23,3,2280,117,8.8
2023-01-23,2020-08-24,19,2299,127,9.56
2023-01-23,2020-08-25,17,2316,137,10.31
2023-01-23,2020-08-26,14,2330,151,11.36
2023-01-23,2020-08-27,18,2348,166,12.49
2023-01-23,2020-08-28,20,2368,179,13.47
2023-01-23,2020-08-29,10,2378,183,13.77
2023-01-23,2020-08-30,2,2380,183,13.77
2023-01-23,2020-08-31,20,2400,195,14.67
2023-01-23,2020-09-01,20,2420,208,15.65
2023-01-23,2020-09-02,26,2446,214,16.1
2023-01-23,2020-09-03,16,2462,213,16.03
2023-01-23,2020-09-04,35,2497,227,17.08
2023-01-23,2020-09-05,25,2522,245,18.44
2023-01-23,2020-09-06,16,2538,258,19.41
2023-01-23,2020-09-07,32,2570,271,20.39
2023-01-23,2020-09-08,22,2592,276,20.77
2023-01-23,2020-09-09,15,2607,277,20.84
2023-01-23,2020-09-10,32,2639,291,21.9
2023-01-23,2020-09-11,23,2662,294,22.12
2023-01-23,2020-09-12,21,2683,305,22.95
2023-01-23,2020-09-13,22,2705,325,24.45
2023-01-23,2020-09-14,24,2729,329,24.76
2023-01-23,2020-09-15,34,2763,343,25.81
2023-01-23,2020-09-16,21,2784,338,25.43
2023-01-23,2020-09-17,36,2820,358,26.94
2023-01-23,2020-09-18,61,2881,384,28.89
2023-01-23,2020-09-19,49,2930,408,30.7
2023-01-23,2020-09-20,17,2947,409,30.78
2023-01-23,2020-09-21,35,2982,412,31
2023-01-23,2020-09-22,57,3039,447,33.63
2023-01-23,2020-09-23,45,3084,477,35.89
2023-01-23,2020-09-24,41,3125,486,36.57
2023-01-23,2020-09-25,47,3172,510,38.38
2023-01-23,2020-09-26,35,3207,524,39.43
2023-01-23,2020-09-27,67,3274,569,42.81
2023-01-23,2020-09-28,48,3322,593,44.62
2023-01-23,2020-09-29,56,3378,615,46.28
2023-01-23,2020-09-30,80,3458,674,50.72
2023-01-23,2020-10-01,57,3515,695,52.3
2023-01-23,2020-10-02,69,3584,703,52.9
2023-01-23,2020-10-03,30,3614,684,51.47
2023-01-23,2020-10-04,10,3624,677,50.94
2023-01-23,2020-10-05,42,3666,684,51.47
2023-01-23,2020-10-06,25,3691,652,49.06
2023-01-23,2020-10-07,76,3767,683,51.39
2023-01-23,2020-10-08,49,3816,691,51.99
2023-01-23,2020-10-09,37,3853,681,51.24
2023-01-23,2020-10-10,19,3872,665,50.04
2023-01-23,2020-10-11,18,3890,616,46.35
2023-01-23,2020-10-12,25,3915,593,44.62
2023-01-23,2020-10-13,39,3954,576,43.34
2023-01-23,2020-10-14,33,3987,529,39.81
2023-01-23,2020-10-15,37,4024,509,38.3
2023-01-23,2020-10-16,35,4059,475,35.74
2023-01-23,2020-10-17,26,4085,471,35.44
2023-01-23,2020-10-18,7,4092,468,35.22
2023-01-23,2020-10-19,42,4134,468,35.22
2023-01-23,2020-10-20,45,4179,488,36.72
2023-01-23,2020-10-21,75,4254,487,36.64
2023-01-23,2020-10-22,53,4307,491,36.95
2023-01-23,2020-10-23,52,4359,506,38.07
2023-01-23,2020-10-24,58,4417,545,41.01
2023-01-23,2020-10-25,17,4434,544,40.93
2023-01-23,2020-10-26,37,4471,556,41.84
2023-01-23,2020-10-27,126,4597,643,48.38
2023-01-23,2020-10-28,80,4677,690,51.92
2023-01-23,2020-10-29,95,4772,748,56.28
2023-01-23,2020-10-30,133,4905,846,63.66
2023-01-23,2020-10-31,81,4986,901,67.8
2023-01-23,2020-11-01,62,5048,956,71.94
2023-01-23,2020-11-02,80,5128,994,74.79
2023-01-23,2020-11-03,208,5336,1157,87.06
2023-01-23,2020-11-04,131,5467,1213,91.27
2023-01-23,2020-11-05,242,5709,1402,105.49
2023-01-23,2020-11-06,228,5937,1578,118.74
2023-01-23,2020-11-07,193,6130,1713,128.9
2023-01-23,2020-11-08,125,6255,1821,137.02
2023-01-23,2020-11-09,128,6383,1912,143.87
2023-01-23,2020-11-10,132,6515,1918,144.32
2023-01-23,2020-11-11,375,6890,2213,166.52
2023-01-23,2020-11-12,258,7148,2376,178.78
2023-01-23,2020-11-13,264,7412,2507,188.64
2023-01-23,2020-11-14,224,7636,2650,199.4
2023-01-23,2020-11-15,211,7847,2799,210.61
2023-01-23,2020-11-16,187,8034,2906,218.66
2023-01-23,2020-11-17,271,8305,2969,223.41
2023-01-23,2020-11-18,411,8716,3249,244.47
2023-01-23,2020-11-19,361,9077,3368,253.43
2023-01-23,2020-11-20,300,9377,3440,258.85
2023-01-23,2020-11-21,349,9726,3596,270.58
2023-01-23,2020-11-22,232,9958,3703,278.64
2023-01-23,2020-11-23,204,10162,3779,284.35
2023-01-23,2020-11-24,383,10545,4030,303.24
2023-01-23,2020-11-25,413,10958,4068,306.1
2023-01-23,2020-11-26,370,11328,4180,314.53
2023-01-23,2020-11-27,374,11702,4290,322.8
2023-01-23,2020-11-28,355,12057,4421,332.66
2023-01-23,2020-11-29,256,12313,4466,336.05
2023-01-23,2020-11-30,188,12501,4467,336.12
2023-01-23,2020-12-01,524,13025,4720,355.16
2023-01-23,2020-12-02,450,13475,4759,358.1
2023-01-23,2020-12-03,470,13945,4868,366.3
2023-01-23,2020-12-04,562,14507,5130,386.01
2023-01-23,2020-12-05,479,14986,5260,395.79
2023-01-23,2020-12-06,249,15235,5277,397.07
2023-01-23,2020-12-07,287,15522,5360,403.32
2023-01-23,2020-12-08,544,16066,5521,415.43
2023-01-23,2020-12-09,545,16611,5653,425.37
2023-01-23,2020-12-10,359,16970,5642,424.54
2023-01-23,2020-12-11,759,17729,6027,453.51
2023-01-23,2020-12-12,342,18071,6014,452.53
2023-01-23,2020-12-13,330,18401,6088,458.1
2023-01-23,2020-12-14,298,18699,6198,466.37
2023-01-23,2020-12-15,589,19288,6263,471.27
2023-01-23,2020-12-16,734,20022,6547,492.63
2023-01-23,2020-12-17,657,20679,6734,506.71
2023-01-23,2020-12-18,564,21243,6736,506.86
2023-01-23,2020-12-19,580,21823,6837,514.46
2023-01-23,2020-12-20,284,22107,6872,517.09
2023-01-23,2020-12-21,565,22672,7150,538.01
2023-01-23,2020-12-22,665,23337,7271,547.11
2023-01-23,2020-12-23,696,24033,7422,558.48
2023-01-23,2020-12-24,574,24607,7637,574.65
2023-01-23,2020-12-25,448,25055,7326,551.25
2023-01-23,2020-12-26,364,25419,7348,552.91
2023-01-23,2020-12-27,418,25837,7436,559.53
2023-01-23,2020-12-28,476,26313,7614,572.92
2023-01-23,2020-12-29,965,27278,7990,601.21
2023-01-23,2020-12-30,732,28010,7988,601.06
2023-01-23,2020-12-31,418,28428,7749,583.08
2023-01-23,2021-01-01,379,28807,7564,569.16
2023-01-23,2021-01-02,342,29149,7326,551.25
2023-01-23,2021-01-03,391,29540,7433,559.3
2023-01-23,2021-01-04,432,29972,7300,549.3
2023-01-23,2021-01-05,720,30692,7355,553.43
2023-01-23,2021-01-06,1085,31777,7744,582.7
2023-01-23,2021-01-07,784,32561,7954,598.51
2023-01-23,2021-01-08,554,33115,8060,606.48
2023-01-23,2021-01-09,425,33540,8121,611.07
2023-01-23,2021-01-10,290,33830,7993,601.44
2023-01-23,2021-01-11,335,34165,7852,590.83
2023-01-23,2021-01-12,856,35021,7743,582.63
2023-01-23,2021-01-13,630,35651,7641,574.95
2023-01-23,2021-01-14,453,36104,7676,577.59
2023-01-23,2021-01-15,617,36721,7914,595.5
2023-01-23,2021-01-16,388,37109,7960,598.96
2023-01-23,2021-01-17,266,37375,7835,589.55
2023-01-23,2021-01-18,600,37975,8003,602.19
2023-01-23,2021-01-19,610,38585,7893,593.92
2023-01-23,2021-01-20,669,39254,7477,562.61
2023-01-23,2021-01-21,495,39749,7188,540.87
2023-01-23,2021-01-22,484,40233,7118,535.6
2023-01-23,2021-01-23,532,40765,7225,543.65
2023-01-23,2021-01-24,257,41022,7192,541.17
2023-01-23,2021-01-25,358,41380,7215,542.9
2023-01-23,2021-01-26,639,42019,6998,526.57
2023-01-23,2021-01-27,691,42710,7059,531.16
2023-01-23,2021-01-28,690,43400,7296,548.99
2023-01-23,2021-01-29,401,43801,7080,532.74
2023-01-23,2021-01-30,468,44269,7160,538.76
2023-01-23,2021-01-31,368,44637,7262,546.44
2023-01-23,2021-02-01,405,45042,7067,531.76
2023-01-23,2021-02-02,688,45730,7145,537.63
2023-01-23,2021-02-03,672,46402,7148,537.86
2023-01-23,2021-02-04,592,46994,7245,545.16
2023-01-23,2021-02-05,590,47584,7351,553.13
2023-01-23,2021-02-06,422,48006,7241,544.86
2023-01-23,2021-02-07,342,48348,7326,551.25
2023-01-23,2021-02-08,544,48892,7512,565.25
2023-01-23,2021-02-09,802,49694,7675,577.51
2023-01-23,2021-02-10,680,50374,7664,576.68
2023-01-23,2021-02-11,714,51088,7688,578.49
2023-01-23,2021-02-12,756,51844,8043,605.2
2023-01-23,2021-02-13,669,52513,8244,620.33
2023-01-23,2021-02-14,414,52927,8290,623.79
2023-01-23,2021-02-15,617,53544,8502,639.74
2023-01-23,2021-02-16,813,54357,8627,649.15
2023-01-23,2021-02-17,1002,55359,8957,673.98
2023-01-23,2021-02-18,953,56312,9318,701.14
2023-01-23,2021-02-19,788,57100,9516,716.04
2023-01-23,2021-02-20,584,57684,9678,728.23
2023-01-23,2021-02-21,832,58516,10168,765.1
2023-01-23,2021-02-22,965,59481,10589,796.78
2023-01-23,2021-02-23,1069,60550,10856,816.87
2023-01-23,2021-02-24,1151,61701,11327,852.31
2023-01-23,2021-02-25,1203,62904,11816,889.11
2023-01-23,2021-02-26,1572,64476,12632,950.51
2023-01-23,2021-02-27,1202,65678,13165,990.61
2023-01-23,2021-02-28,1027,66705,13778,1036.74
2023-01-23,2021-03-01,1113,67818,14274,1074.06
2023-01-23,2021-03-02,1459,69277,14920,1122.67
2023-01-23,2021-03-03,1421,70698,15339,1154.2
2023-01-23,2021-03-04,1536,72234,15922,1198.07
2023-01-23,2021-03-05,1541,73775,16675,1254.73
2023-01-23,2021-03-06,1318,75093,17409,1309.96
2023-01-23,2021-03-07,1180,76273,17757,1336.14
2023-01-23,2021-03-08,1309,77582,18101,1362.03
2023-01-23,2021-03-09,1485,79067,18517,1393.33
2023-01-23,2021-03-10,1960,81027,19326,1454.2
2023-01-23,2021-03-11,1361,82388,19484,1466.09
2023-01-23,2021-03-12,1587,83975,19499,1467.22
2023-01-23,2021-03-13,936,84911,19233,1447.2
2023-01-23,2021-03-14,1280,86191,19486,1466.24
2023-01-23,2021-03-15,1466,87657,19839,1492.8
2023-01-23,2021-03-16,1783,89440,20163,1517.18
2023-01-23,2021-03-17,1702,91142,20444,1538.33
2023-01-23,2021-03-18,1751,92893,20659,1554.51
2023-01-23,2021-03-19,1252,94145,20370,1532.76
2023-01-23,2021-03-20,1375,95520,20427,1537.05
2023-01-23,2021-03-21,993,96513,20240,1522.98
2023-01-23,2021-03-22,1063,97576,19994,1504.47
2023-01-23,2021-03-23,1556,99132,20065,1509.81
2023-01-23,2021-03-24,1432,100564,19537,1470.08
2023-01-23,2021-03-25,1152,101716,19328,1454.35
2023-01-23,2021-03-26,1151,102867,18892,1421.55
2023-01-23,2021-03-27,894,103761,18850,1418.39
2023-01-23,2021-03-28,585,104346,18155,1366.09
2023-01-23,2021-03-29,1204,105550,17893,1346.37
2023-01-23,2021-03-30,1019,106569,17129,1288.89
2023-01-23,2021-03-31,1114,107683,16541,1244.64
2023-01-23,2021-04-01,913,108596,15703,1181.59
2023-01-23,2021-04-02,524,109120,14975,1126.81
2023-01-23,2021-04-03,490,109610,14090,1060.21
2023-01-23,2021-04-04,397,110007,13494,1015.37
2023-01-23,2021-04-05,922,110929,13353,1004.76
2023-01-23,2021-04-06,996,111925,12793,962.62
2023-01-23,2021-04-07,771,112696,12132,912.88
2023-01-23,2021-04-08,685,113381,11665,877.74
2023-01-23,2021-04-09,648,114029,11162,839.89
2023-01-23,2021-04-10,451,114480,10719,806.56
2023-01-23,2021-04-11,277,114757,10411,783.39
2023-01-23,2021-04-12,648,115405,9855,741.55
2023-01-23,2021-04-13,559,115964,9395,706.94
2023-01-23,2021-04-14,579,116543,8860,666.68
2023-01-23,2021-04-15,488,117031,8435,634.7
2023-01-23,2021-04-16,340,117371,8251,620.85
2023-01-23,2021-04-17,547,117918,8308,625.14
2023-01-23,2021-04-18,235,118153,8146,612.95
2023-01-23,2021-04-19,543,118696,7767,584.43
2023-01-23,2021-04-20,482,119178,7253,545.76
2023-01-23,2021-04-21,445,119623,6927,521.23
2023-01-23,2021-04-22,399,120022,6641,499.71
2023-01-23,2021-04-23,392,120414,6385,480.45
2023-01-23,2021-04-24,217,120631,6151,462.84
2023-01-23,2021-04-25,169,120800,6043,454.71
2023-01-23,2021-04-26,478,121278,5873,441.92
2023-01-23,2021-04-27,403,121681,5717,430.18
2023-01-23,2021-04-28,429,122110,5567,418.89
2023-01-23,2021-04-29,369,122479,5448,409.94
2023-01-23,2021-04-30,413,122892,5521,415.43
2023-01-23,2021-05-01,177,123069,5151,387.59
2023-01-23,2021-05-02,178,123247,5094,383.3
2023-01-23,2021-05-03,406,123653,4957,372.99
2023-01-23,2021-05-04,429,124082,4904,369.01
2023-01-23,2021-05-05,367,124449,4826,363.14
2023-01-23,2021-05-06,386,124835,4813,362.16
2023-01-23,2021-05-07,352,125187,4773,359.15
2023-01-23,2021-05-08,157,125344,4713,354.63
2023-01-23,2021-05-09,199,125543,4743,356.89
2023-01-23,2021-05-10,363,125906,4628,348.24
2023-01-23,2021-05-11,373,126279,4598,345.98
2023-01-23,2021-05-12,303,126582,4472,336.5
2023-01-23,2021-05-13,285,126867,4388,330.18
2023-01-23,2021-05-14,283,127150,4258,320.4
2023-01-23,2021-05-15,134,127284,4215,317.16
2023-01-23,2021-05-16,153,127437,4190,315.28
2023-01-23,2021-05-17,298,127735,4082,307.15
2023-01-23,2021-05-18,257,127992,3910,294.21
2023-01-23,2021-05-19,242,128234,3785,284.81
2023-01-23,2021-05-20,229,128463,3628,272.99
2023-01-23,2021-05-21,181,128644,3457,260.13
2023-01-23,2021-05-22,103,128747,3403,256.06
2023-01-23,2021-05-23,77,128824,3281,246.88
2023-01-23,2021-05-24,164,128988,3082,231.91
2023-01-23,2021-05-25,186,129174,2895,217.84
2023-01-23,2021-05-26,147,129321,2739,206.1
2023-01-23,2021-05-27,141,129462,2595,195.26
2023-01-23,2021-05-28,128,129590,2440,183.6
2023-01-23,2021-05-29,66,129656,2372,178.48
2023-01-23,2021-05-30,60,129716,2279,171.49
2023-01-23,2021-05-31,133,129849,2114,159.07
2023-01-23,2021-06-01,131,129980,1988,149.59
2023-01-23,2021-06-02,107,130087,1853,139.43
2023-01-23,2021-06-03,100,130187,1724,129.72
2023-01-23,2021-06-04,63,130250,1606,120.84
2023-01-23,2021-06-05,52,130302,1555,117.01
2023-01-23,2021-06-06,39,130341,1517,114.15
2023-01-23,2021-06-07,85,130426,1438,108.2
2023-01-23,2021-06-08,69,130495,1321,99.4
2023-01-23,2021-06-09,54,130549,1228,92.4
2023-01-23,2021-06-10,54,130603,1141,85.86
2023-01-23,2021-06-11,53,130656,1066,80.21
2023-01-23,2021-06-12,38,130694,1038,78.11
2023-01-23,2021-06-13,28,130722,1006,75.7
2023-01-23,2021-06-14,62,130784,935,70.35
2023-01-23,2021-06-15,60,130844,864,65.01
2023-01-23,2021-06-16,41,130885,798,60.05
2023-01-23,2021-06-17,56,130941,754,56.74
2023-01-23,2021-06-18,35,130976,726,54.63
2023-01-23,2021-06-19,26,131002,700,52.67
2023-01-23,2021-06-20,12,131014,673,50.64
2023-01-23,2021-06-21,37,131051,625,47.03
2023-01-23,2021-06-22,26,131077,582,43.79
2023-01-23,2021-06-23,20,131097,548,41.23
2023-01-23,2021-06-24,12,131109,506,38.07
2023-01-23,2021-06-25,34,131143,487,36.64
2023-01-23,2021-06-26,27,131170,476,35.82
2023-01-23,2021-06-27,15,131185,463,34.84
2023-01-23,2021-06-28,47,131232,448,33.71
2023-01-23,2021-06-29,37,131269,425,31.98
2023-01-23,2021-06-30,21,131290,405,30.47
2023-01-23,2021-07-01,39,131329,388,29.2
2023-01-23,2021-07-02,39,131368,392,29.5
2023-01-23,2021-07-03,27,131395,393,29.57
2023-01-23,2021-07-04,20,131415,401,30.17
2023-01-23,2021-07-05,50,131465,414,31.15
2023-01-23,2021-07-06,42,131507,430,32.36
2023-01-23,2021-07-07,58,131565,468,35.22
2023-01-23,2021-07-08,39,131604,495,37.25
2023-01-23,2021-07-09,64,131668,525,39.5
2023-01-23,2021-07-10,27,131695,525,39.5
2023-01-23,2021-07-11,22,131717,532,40.03
2023-01-23,2021-07-12,57,131774,542,40.78
2023-01-23,2021-07-13,56,131830,561,42.21
2023-01-23,2021-07-14,64,131894,604,45.45
2023-01-23,2021-07-15,62,131956,627,47.18
2023-01-23,2021-07-16,64,132020,652,49.06
2023-01-23,2021-07-17,41,132061,666,50.11
2023-01-23,2021-07-18,35,132096,681,51.24
2023-01-23,2021-07-19,81,132177,712,53.58
2023-01-23,2021-07-20,97,132274,767,57.71
2023-01-23,2021-07-21,121,132395,830,62.45
2023-01-23,2021-07-22,84,132479,875,65.84
2023-01-23,2021-07-23,106,132585,917,69
2023-01-23,2021-07-24,91,132676,981,73.82
2023-01-23,2021-07-25,67,132743,1026,77.2
2023-01-23,2021-07-26,192,132935,1161,87.36
2023-01-23,2021-07-27,173,133108,1278,96.16
2023-01-23,2021-07-28,220,133328,1434,107.9
2023-01-23,2021-07-29,181,133509,1553,116.86
2023-01-23,2021-07-30,249,133758,1738,130.78
2023-01-23,2021-07-31,127,133885,1824,137.25
2023-01-23,2021-08-01,87,133972,1876,141.16
2023-01-23,2021-08-02,221,134193,2016,151.7
2023-01-23,2021-08-03,232,134425,2151,161.85
2023-01-23,2021-08-04,258,134683,2288,172.16
2023-01-23,2021-08-05,242,134925,2446,184.05
2023-01-23,2021-08-06,242,135167,2582,194.28
2023-01-23,2021-08-07,126,135293,2617,196.92
2023-01-23,2021-08-08,146,135439,2696,202.86
2023-01-23,2021-08-09,290,135729,2794,210.24
2023-01-23,2021-08-10,343,136072,2964,223.03
2023-01-23,2021-08-11,368,136440,3112,234.17
2023-01-23,2021-08-12,281,136721,3212,241.69
2023-01-23,2021-08-13,290,137011,3253,244.77
2023-01-23,2021-08-14,203,137214,3329,250.49
2023-01-23,2021-08-15,163,137377,3405,256.21
2023-01-23,2021-08-16,358,137735,3542,266.52
2023-01-23,2021-08-17,287,138022,3597,270.66
2023-01-23,2021-08-18,357,138379,3696,278.11
2023-01-23,2021-08-19,330,138709,3784,284.73
2023-01-23,2021-08-20,218,138927,3760,282.92
2023-01-23,2021-08-21,101,139028,3735,281.04
2023-01-23,2021-08-22,318,139346,3907,293.99
2023-01-23,2021-08-23,374,139720,3991,300.31
2023-01-23,2021-08-24,437,140157,4085,307.38
2023-01-23,2021-08-25,402,140559,4119,309.94
2023-01-23,2021-08-26,351,140910,4189,315.21
2023-01-23,2021-08-27,324,141234,4223,317.76
2023-01-23,2021-08-28,330,141564,4350,327.32
2023-01-23,2021-08-29,255,141819,4442,334.24
2023-01-23,2021-08-30,359,142178,4443,334.32
2023-01-23,2021-08-31,408,142586,4564,343.42
2023-01-23,2021-09-01,474,143060,4681,352.23
2023-01-23,2021-09-02,347,143407,4698,353.51
2023-01-23,2021-09-03,353,143760,4833,363.66
2023-01-23,2021-09-04,255,144015,4987,375.25
2023-01-23,2021-09-05,211,144226,4880,367.2
2023-01-23,2021-09-06,390,144616,4896,368.4
2023-01-23,2021-09-07,486,145102,4945,372.09
2023-01-23,2021-09-08,467,145569,5010,376.98
2023-01-23,2021-09-09,540,146109,5199,391.2
2023-01-23,2021-09-10,493,146602,5368,403.92
2023-01-23,2021-09-11,329,146931,5367,403.84
2023-01-23,2021-09-12,268,147199,5380,404.82
2023-01-23,2021-09-13,472,147671,5493,413.33
2023-01-23,2021-09-14,525,148196,5610,422.13
2023-01-23,2021-09-15,510,148706,5646,424.84
2023-01-23,2021-09-16,532,149238,5831,438.76
2023-01-23,2021-09-17,391,149629,5869,441.62
2023-01-23,2021-09-18,462,150091,6076,457.19
2023-01-23,2021-09-19,366,150457,6231,468.86
2023-01-23,2021-09-20,463,150920,6304,474.35
2023-01-23,2021-09-21,689,151609,6507,489.63
2023-01-23,2021-09-22,590,152199,6630,498.88
2023-01-23,2021-09-23,546,152745,6636,499.33
2023-01-23,2021-09-24,643,153388,6786,510.62
2023-01-23,2021-09-25,464,153852,6921,520.78
2023-01-23,2021-09-26,390,154242,7043,529.96
2023-01-23,2021-09-27,796,155038,7367,554.34
2023-01-23,2021-09-28,745,155783,7587,570.89
2023-01-23,2021-09-29,791,156574,7868,592.03
2023-01-23,2021-09-30,730,157304,8066,606.93
2023-01-23,2021-10-01,741,158045,8416,633.27
2023-01-23,2021-10-02,627,158672,8581,645.69
2023-01-23,2021-10-03,540,159212,8755,658.78
2023-01-23,2021-10-04,892,160104,9184,691.06
2023-01-23,2021-10-05,1046,161150,9541,717.92
2023-01-23,2021-10-06,948,162098,9899,744.86
2023-01-23,2021-10-07,954,163052,10307,775.56
2023-01-23,2021-10-08,1067,164119,10731,807.46
2023-01-23,2021-10-09,814,164933,11081,833.8
2023-01-23,2021-10-10,724,165657,11415,858.93
2023-01-23,2021-10-11,1256,166913,11875,893.55
2023-01-23,2021-10-12,1229,168142,12359,929.96
2023-01-23,2021-10-13,1055,169197,12623,949.83
2023-01-23,2021-10-14,1277,170474,13170,990.99
2023-01-23,2021-10-15,1238,171712,13667,1028.39
2023-01-23,2021-10-16,1117,172829,14157,1065.26
2023-01-23,2021-10-17,820,173649,14437,1086.33
2023-01-23,2021-10-18,1101,174750,14646,1102.05
2023-01-23,2021-10-19,1346,176096,14946,1124.63
2023-01-23,2021-10-20,1506,177602,15504,1166.61
2023-01-23,2021-10-21,1322,178924,15872,1194.3
2023-01-23,2021-10-22,1642,180566,16447,1237.57
2023-01-23,2021-10-23,1786,182352,17419,1310.71
2023-01-23,2021-10-24,1282,183634,17977,1352.7
2023-01-23,2021-10-25,1192,184826,17913,1347.88
2023-01-23,2021-10-26,2025,186851,18709,1407.78
2023-01-23,2021-10-27,1996,188847,19650,1478.58
2023-01-23,2021-10-28,1679,190526,20052,1508.83
2023-01-23,2021-10-29,1890,192416,20704,1557.89
2023-01-23,2021-10-30,1877,194293,21464,1615.08
2023-01-23,2021-10-31,1411,195704,22055,1659.55
2023-01-23,2021-11-01,1571,197275,22525,1694.91
2023-01-23,2021-11-02,2308,199583,23487,1767.3
2023-01-23,2021-11-03,1945,201528,23926,1800.33
2023-01-23,2021-11-04,1435,202963,24039,1808.84
2023-01-23,2021-11-05,1522,204485,23919,1799.81
2023-01-23,2021-11-06,947,205432,23080,1736.68
2023-01-23,2021-11-07,790,206222,22588,1699.65
2023-01-23,2021-11-08,1087,207309,22483,1691.75
2023-01-23,2021-11-09,1354,208663,21812,1641.26
2023-01-23,2021-11-10,1181,209844,20997,1579.94
2023-01-23,2021-11-11,1040,210884,20358,1531.86
2023-01-23,2021-11-12,993,211877,19461,1464.36
2023-01-23,2021-11-13,561,212438,18145,1365.34
2023-01-23,2021-11-14,512,212950,17246,1297.69
2023-01-23,2021-11-15,871,213821,16546,1245.02
2023-01-23,2021-11-16,1021,214842,15259,1148.18
2023-01-23,2021-11-17,873,215715,14187,1067.51
2023-01-23,2021-11-18,715,216430,13467,1013.34
2023-01-23,2021-11-19,464,216894,12409,933.73
2023-01-23,2021-11-20,837,217731,12299,925.45
2023-01-23,2021-11-21,403,218134,11912,896.33
2023-01-23,2021-11-22,820,218954,11645,876.24
2023-01-23,2021-11-23,655,219609,10946,823.64
2023-01-23,2021-11-24,621,220230,10386,781.5
2023-01-23,2021-11-25,636,220866,9982,751.1
2023-01-23,2021-11-26,646,221512,9635,724.99
2023-01-23,2021-11-27,389,221901,9463,712.05
2023-01-23,2021-11-28,311,222212,9262,696.93
2023-01-23,2021-11-29,722,222934,9113,685.72
2023-01-23,2021-11-30,587,223521,8679,653.06
2023-01-23,2021-12-01,522,224043,8328,626.65
2023-01-23,2021-12-02,507,224550,8120,611
2023-01-23,2021-12-03,460,225010,8116,610.7
2023-01-23,2021-12-04,340,225350,7619,573.3
2023-01-23,2021-12-05,301,225651,7517,565.62
2023-01-23,2021-12-06,547,226198,7244,545.08
2023-01-23,2021-12-07,469,226667,7058,531.09
2023-01-23,2021-12-08,550,227217,6987,525.74
2023-01-23,2021-12-09,595,227812,6946,522.66
2023-01-23,2021-12-10,457,228269,6757,508.44
2023-01-23,2021-12-11,377,228646,6745,507.53
2023-01-23,2021-12-12,317,228963,6751,507.99
2023-01-23,2021-12-13,618,229581,6647,500.16
2023-01-23,2021-12-14,658,230239,6718,505.5
2023-01-23,2021-12-15,648,230887,6844,514.98
2023-01-23,2021-12-16,602,231489,6939,522.13
2023-01-23,2021-12-17,578,232067,7057,531.01
2023-01-23,2021-12-18,428,232495,7145,537.63
2023-01-23,2021-12-19,387,232882,7231,544.1
2023-01-23,2021-12-20,864,233746,7548,567.96
2023-01-23,2021-12-21,725,234471,7804,587.22
2023-01-23,2021-12-22,865,235336,8119,610.92
2023-01-23,2021-12-23,719,236055,8243,620.25
2023-01-23,2021-12-24,469,236524,8255,621.15
2023-01-23,2021-12-25,434,236958,8312,625.44
2023-01-23,2021-12-26,538,237496,8533,642.07
2023-01-23,2021-12-27,984,238480,8899,669.61
2023-01-23,2021-12-28,883,239363,9124,686.54
2023-01-23,2021-12-29,1386,240749,9862,742.08
2023-01-23,2021-12-30,1072,241821,10332,777.44
2023-01-23,2021-12-31,721,242542,10475,788.2
2023-01-23,2022-01-01,430,242972,10477,788.35
2023-01-23,2022-01-02,691,243663,10781,811.23
2023-01-23,2022-01-03,1508,245171,11425,859.68
2023-01-23,2022-01-04,1500,246671,12200,918
2023-01-23,2022-01-05,1655,248326,12990,977.44
2023-01-23,2022-01-06,1737,250063,14008,1054.04
2023-01-23,2022-01-07,1654,251717,15193,1143.21
2023-01-23,2022-01-08,1291,253008,16050,1207.7
2023-01-23,2022-01-09,1263,254271,16775,1262.25
2023-01-23,2022-01-10,1996,256267,17787,1338.4
2023-01-23,2022-01-11,2210,258477,19114,1438.25
2023-01-23,2022-01-12,2452,260929,20180,1518.46
2023-01-23,2022-01-13,2102,263031,21210,1595.97
2023-01-23,2022-01-14,2242,265273,22731,1710.41
2023-01-23,2022-01-15,2412,267685,24713,1859.55
2023-01-23,2022-01-16,2121,269806,26143,1967.15
2023-01-23,2022-01-17,2311,272117,26946,2027.58
2023-01-23,2022-01-18,3186,275303,28632,2154.44
2023-01-23,2022-01-19,3877,279180,30854,2321.64
2023-01-23,2022-01-20,4526,283706,33643,2531.5
2023-01-23,2022-01-21,4828,288534,36817,2770.33
2023-01-23,2022-01-22,3700,292234,39226,2951.6
2023-01-23,2022-01-23,5076,297310,43039,3238.51
2023-01-23,2022-01-24,5195,302505,46238,3479.22
2023-01-23,2022-01-25,5887,308392,49915,3755.9
2023-01-23,2022-01-26,6274,314666,53737,4043.49
2023-01-23,2022-01-27,5870,320536,57505,4327.02
2023-01-23,2022-01-28,7171,327707,62434,4697.9
2023-01-23,2022-01-29,5998,333705,66020,4967.73
2023-01-23,2022-01-30,4997,338702,68896,5184.14
2023-01-23,2022-01-31,6547,345249,73132,5502.88
2023-01-23,2022-02-01,7243,352492,77189,5808.16
2023-01-23,2022-02-02,6886,359378,80198,6034.57
2023-01-23,2022-02-03,8045,367423,83717,6299.36
2023-01-23,2022-02-04,7849,375272,86738,6526.68
2023-01-23,2022-02-05,7082,382354,90120,6781.16
2023-01-23,2022-02-06,4631,386985,89675,6747.68
2023-01-23,2022-02-07,6316,393301,90796,6832.03
2023-01-23,2022-02-08,6704,400005,91613,6893.5
2023-01-23,2022-02-09,6611,406616,91950,6918.86
2023-01-23,2022-02-10,5129,411745,91209,6863.1
2023-01-23,2022-02-11,5799,417544,89837,6759.87
2023-01-23,2022-02-12,4634,422178,88473,6657.23
2023-01-23,2022-02-13,2905,425083,86381,6499.82
2023-01-23,2022-02-14,3527,428610,83361,6272.57
2023-01-23,2022-02-15,8467,437077,84585,6364.67
2023-01-23,2022-02-16,6520,443597,84219,6337.13
2023-01-23,2022-02-17,6751,450348,82925,6239.77
2023-01-23,2022-02-18,6996,457344,82072,6175.58
2023-01-23,2022-02-19,4138,461482,79128,5954.06
2023-01-23,2022-02-20,2990,464472,77487,5830.58
2023-01-23,2022-02-21,5285,469757,76456,5753
2023-01-23,2022-02-22,6589,476346,76341,5744.35
2023-01-23,2022-02-23,4409,480755,74139,5578.66
2023-01-23,2022-02-24,5042,485797,74052,5572.11
2023-01-23,2022-02-25,4012,489809,72265,5437.65
2023-01-23,2022-02-26,4202,494011,71833,5405.14
2023-01-23,2022-02-27,2291,496302,71219,5358.94
2023-01-23,2022-02-28,4671,500973,72363,5445.02
2023-01-23,2022-03-01,5087,506060,68983,5190.69
2023-01-23,2022-03-02,3573,509633,66036,4968.94
2023-01-23,2022-03-03,3325,512958,62610,4711.15
2023-01-23,2022-03-04,3055,516013,58669,4414.6
2023-01-23,2022-03-05,1646,517659,56177,4227.09
2023-01-23,2022-03-06,1396,519055,54583,4107.15
2023-01-23,2022-03-07,3317,522372,52615,3959.06
2023-01-23,2022-03-08,2877,525249,48903,3679.75
2023-01-23,2022-03-09,2478,527727,46972,3534.45
2023-01-23,2022-03-10,2177,529904,44107,3318.87
2023-01-23,2022-03-11,1892,531796,41987,3159.35
2023-01-23,2022-03-12,1376,533172,39161,2946.7
2023-01-23,2022-03-13,929,534101,37799,2844.22
2023-01-23,2022-03-14,2716,536817,35844,2697.11
2023-01-23,2022-03-15,2144,538961,32901,2475.67
2023-01-23,2022-03-16,1752,540713,31080,2338.64
2023-01-23,2022-03-17,1521,542234,29276,2202.9
2023-01-23,2022-03-18,1372,543606,27593,2076.26
2023-01-23,2022-03-19,840,544446,26787,2015.61
2023-01-23,2022-03-20,671,545117,26062,1961.06
2023-01-23,2022-03-21,2011,547128,24756,1862.79
2023-01-23,2022-03-22,1840,548968,23719,1784.76
2023-01-23,2022-03-23,1457,550425,22698,1707.93
2023-01-23,2022-03-24,1474,551899,21995,1655.03
2023-01-23,2022-03-25,1289,553188,21392,1609.66
2023-01-23,2022-03-26,652,553840,20668,1555.18
2023-01-23,2022-03-27,577,554417,20316,1528.7
2023-01-23,2022-03-28,1462,555879,19062,1434.34
2023-01-23,2022-03-29,1418,557297,18336,1379.71
2023-01-23,2022-03-30,1174,558471,17758,1336.22
2023-01-23,2022-03-31,1025,559496,17262,1298.89
2023-01-23,2022-04-01,940,560436,16830,1266.39
2023-01-23,2022-04-02,461,560897,16451,1237.87
2023-01-23,2022-04-03,436,561333,16216,1220.19
2023-01-23,2022-04-04,1130,562463,15335,1153.9
2023-01-23,2022-04-05,1012,563475,14507,1091.59
2023-01-23,2022-04-06,903,564378,13953,1049.91
2023-01-23,2022-04-07,845,565223,13324,1002.58
2023-01-23,2022-04-08,756,565979,12791,962.47
2023-01-23,2022-04-09,350,566329,12489,939.75
2023-01-23,2022-04-10,282,566611,12194,917.55
2023-01-23,2022-04-11,919,567530,11651,876.69
2023-01-23,2022-04-12,635,568165,10868,817.77
2023-01-23,2022-04-13,634,568799,10328,777.14
2023-01-23,2022-04-14,464,569263,9767,734.93
2023-01-23,2022-04-15,261,569524,9088,683.83
2023-01-23,2022-04-16,286,569810,8913,670.67
2023-01-23,2022-04-17,184,569994,8661,651.7
2023-01-23,2022-04-18,696,570690,8227,619.05
2023-01-23,2022-04-19,214,570904,7429,559
2023-01-23,2022-04-20,818,571722,7344,552.61
2023-01-23,2022-04-21,385,572107,6884,517.99
2023-01-23,2022-04-22,362,572469,6490,488.35
2023-01-23,2022-04-23,184,572653,6324,475.86
2023-01-23,2022-04-24,152,572805,6194,466.07
2023-01-23,2022-04-25,535,573340,5810,437.18
2023-01-23,2022-04-26,375,573715,5550,417.61
2023-01-23,2022-04-27,326,574041,5242,394.44
2023-01-23,2022-04-28,294,574335,5072,381.65
2023-01-23,2022-04-29,277,574612,5088,382.85
2023-01-23,2022-04-30,142,574754,4944,372.02
2023-01-23,2022-05-01,110,574864,4870,366.45
2023-01-23,2022-05-02,560,575424,4734,356.21
2023-01-23,2022-05-03,258,575682,4778,359.52
2023-01-23,2022-05-04,258,575940,4218,317.39
2023-01-23,2022-05-05,220,576160,4053,304.97
2023-01-23,2022-05-06,186,576346,3877,291.73
2023-01-23,2022-05-07,86,576432,3779,284.35
2023-01-23,2022-05-08,33,576465,3660,275.4
2023-01-23,2022-05-09,317,576782,3442,259
2023-01-23,2022-05-10,196,576978,3263,245.53
2023-01-23,2022-05-11,185,577163,3122,234.92
2023-01-23,2022-05-12,110,577273,2938,221.07
2023-01-23,2022-05-13,198,577471,2859,215.13
2023-01-23,2022-05-14,86,577557,2803,210.91
2023-01-23,2022-05-15,108,577665,2801,210.76
2023-01-23,2022-05-16,216,577881,2457,184.88
2023-01-23,2022-05-17,160,578041,2359,177.51
2023-01-23,2022-05-18,184,578225,2285,171.94
2023-01-23,2022-05-19,129,578354,2194,165.09
2023-01-23,2022-05-20,151,578505,2159,162.46
2023-01-23,2022-05-21,70,578575,2143,161.25
2023-01-23,2022-05-22,69,578644,2179,163.96
2023-01-23,2022-05-23,145,578789,2007,151.02
2023-01-23,2022-05-24,129,578918,1940,145.98
2023-01-23,2022-05-25,157,579075,1912,143.87
2023-01-23,2022-05-26,136,579211,1938,145.83
2023-01-23,2022-05-27,127,579338,1867,140.48
2023-01-23,2022-05-28,78,579416,1859,139.88
2023-01-23,2022-05-29,60,579476,1811,136.27
2023-01-23,2022-05-30,167,579643,1762,132.58
2023-01-23,2022-05-31,150,579793,1752,131.83
2023-01-23,2022-06-01,135,579928,1703,128.14
2023-01-23,2022-06-02,124,580052,1698,127.77
2023-01-23,2022-06-03,120,580172,1667,125.43
2023-01-23,2022-06-04,57,580229,1654,124.46
2023-01-23,2022-06-05,45,580274,1630,122.65
2023-01-23,2022-06-06,167,580441,1652,124.31
2023-01-23,2022-06-07,146,580587,1669,125.59
2023-01-23,2022-06-08,151,580738,1663,125.13
2023-01-23,2022-06-09,151,580889,1678,126.26
2023-01-23,2022-06-10,126,581015,1677,126.19
2023-01-23,2022-06-11,57,581072,1656,124.61
2023-01-23,2022-06-12,45,581117,1641,123.48
2023-01-23,2022-06-13,112,581229,1586,119.34
2023-01-23,2022-06-14,162,581391,1598,120.24
2023-01-23,2022-06-15,129,581520,1592,119.79
2023-01-23,2022-06-16,170,581690,1638,123.25
2023-01-23,2022-06-17,105,581795,1623,122.12
2023-01-23,2022-06-18,98,581893,1664,125.21
2023-01-23,2022-06-19,50,581943,1669,125.59
2023-01-23,2022-06-20,152,582095,1654,124.46
2023-01-23,2022-06-21,229,582324,1737,130.7
2023-01-23,2022-06-22,180,582504,1766,132.88
2023-01-23,2022-06-23,41,582545,1656,124.61
2023-01-23,2022-06-24,51,582596,1581,118.96
2023-01-23,2022-06-25,106,582702,1630,122.65
2023-01-23,2022-06-26,48,582750,1633,122.88
2023-01-23,2022-06-27,223,582973,1744,131.23
2023-01-23,2022-06-28,270,583243,1852,139.36
2023-01-23,2022-06-29,244,583487,1967,148.01
2023-01-23,2022-06-30,230,583717,2027,152.52
2023-01-23,2022-07-01,206,583923,2128,160.12
2023-01-23,2022-07-02,104,584027,2134,160.57
2023-01-23,2022-07-03,72,584099,2156,162.23
2023-01-23,2022-07-04,218,584317,2222,167.2
2023-01-23,2022-07-05,175,584492,2168,163.13
2023-01-23,2022-07-06,235,584727,2223,167.27
2023-01-23,2022-07-07,208,584935,2390,179.84
2023-01-23,2022-07-08,177,585112,2516,189.32
2023-01-23,2022-07-09,105,585217,2515,189.24
2023-01-23,2022-07-10,46,585263,2513,189.09
2023-01-23,2022-07-11,250,585513,2540,191.12
2023-01-23,2022-07-12,272,585785,2542,191.28
2023-01-23,2022-07-13,253,586038,2551,191.95
2023-01-23,2022-07-14,282,586320,2603,195.87
2023-01-23,2022-07-15,262,586582,2659,200.08
2023-01-23,2022-07-16,149,586731,2704,203.46
2023-01-23,2022-07-17,98,586829,2730,205.42
2023-01-23,2022-07-18,314,587143,2826,212.64
2023-01-23,2022-07-19,313,587456,2964,223.03
2023-01-23,2022-07-20,289,587745,3018,227.09
2023-01-23,2022-07-21,388,588133,3198,240.64
2023-01-23,2022-07-22,332,588465,3353,252.3
2023-01-23,2022-07-23,208,588673,3456,260.05
2023-01-23,2022-07-24,154,588827,3564,268.18
2023-01-23,2022-07-25,349,589176,3663,275.63
2023-01-23,2022-07-26,371,589547,3762,283.08
2023-01-23,2022-07-27,420,589967,3929,295.64
2023-01-23,2022-07-28,376,590343,4023,302.71
2023-01-23,2022-07-29,417,590760,4178,314.38
2023-01-23,2022-07-30,192,590952,4221,317.61
2023-01-23,2022-07-31,104,591056,4227,318.06
2023-01-23,2022-08-01,434,591490,4347,327.09
2023-01-23,2022-08-02,434,591924,4468,336.2
2023-01-23,2022-08-03,377,592301,4556,342.82
2023-01-23,2022-08-04,353,592654,4521,340.19
2023-01-23,2022-08-05,315,592969,4504,338.91
2023-01-23,2022-08-06,143,593112,4439,334.02
2023-01-23,2022-08-07,181,593293,4466,336.05
2023-01-23,2022-08-08,388,593681,4505,338.98
2023-01-23,2022-08-09,352,594033,4486,337.55
2023-01-23,2022-08-10,337,594370,4403,331.31
2023-01-23,2022-08-11,296,594666,4323,325.29
2023-01-23,2022-08-12,299,594965,4205,316.41
2023-01-23,2022-08-13,171,595136,4184,314.83
2023-01-23,2022-08-14,89,595225,4169,313.7
2023-01-23,2022-08-15,308,595533,4043,304.22
2023-01-23,2022-08-16,283,595816,3892,292.86
2023-01-23,2022-08-17,254,596070,3769,283.6
2023-01-23,2022-08-18,196,596266,3612,271.79
2023-01-23,2022-08-19,229,596495,3526,265.32
2023-01-23,2022-08-20,100,596595,3483,262.08
2023-01-23,2022-08-21,56,596651,3358,252.68
2023-01-23,2022-08-22,226,596877,3196,240.49
2023-01-23,2022-08-23,216,597093,3060,230.25
2023-01-23,2022-08-24,192,597285,2915,219.34
2023-01-23,2022-08-25,170,597455,2789,209.86
2023-01-23,2022-08-26,183,597638,2673,201.13
2023-01-23,2022-08-27,81,597719,2583,194.36
2023-01-23,2022-08-28,39,597758,2533,190.6
2023-01-23,2022-08-29,195,597953,2420,182.1
2023-01-23,2022-08-30,137,598090,2274,171.11
2023-01-23,2022-08-31,137,598227,2157,162.31
2023-01-23,2022-09-01,111,598338,2072,155.91
2023-01-23,2022-09-02,137,598475,1980,148.99
2023-01-23,2022-09-03,71,598546,1951,146.8
2023-01-23,2022-09-04,33,598579,1928,145.07
2023-01-23,2022-09-05,174,598753,1876,141.16
2023-01-23,2022-09-06,175,598928,1835,138.08
2023-01-23,2022-09-07,151,599079,1794,134.99
2023-01-23,2022-09-08,131,599210,1755,132.06
2023-01-23,2022-09-09,144,599354,1716,129.12
2023-01-23,2022-09-10,92,599446,1727,129.95
2023-01-23,2022-09-11,46,599492,1734,130.48
2023-01-23,2022-09-12,227,599719,1766,132.88
2023-01-23,2022-09-13,198,599917,1827,137.47
2023-01-23,2022-09-14,175,600092,1865,140.33
2023-01-23,2022-09-15,196,600288,1950,146.73
2023-01-23,2022-09-16,189,600477,2002,150.64
2023-01-23,2022-09-17,122,600599,2053,154.48
2023-01-23,2022-09-18,81,600680,2101,158.09
2023-01-23,2022-09-19,230,600910,2157,162.31
2023-01-23,2022-09-20,192,601102,2174,163.58
2023-01-23,2022-09-21,236,601338,2259,169.98
2023-01-23,2022-09-22,186,601524,2314,174.12
2023-01-23,2022-09-23,178,601702,2348,176.68
2023-01-23,2022-09-24,89,601791,2345,176.45
2023-01-23,2022-09-25,78,601869,2377,178.86
2023-01-23,2022-09-26,240,602109,2390,179.84
2023-01-23,2022-09-27,245,602354,2437,183.37
2023-01-23,2022-09-28,214,602568,2476,186.31
2023-01-23,2022-09-29,201,602769,2481,186.69
2023-01-23,2022-09-30,213,602982,2505,188.49
2023-01-23,2022-10-01,108,603090,2491,187.44
2023-01-23,2022-10-02,94,603184,2504,188.42
2023-01-23,2022-10-03,204,603388,2478,186.46
2023-01-23,2022-10-04,241,603629,2527,190.15
2023-01-23,2022-10-05,202,603831,2493,187.59
2023-01-23,2022-10-06,190,604021,2497,187.89
2023-01-23,2022-10-07,192,604213,2511,188.94
2023-01-23,2022-10-08,95,604308,2517,189.39
2023-01-23,2022-10-09,71,604379,2510,188.87
2023-01-23,2022-10-10,212,604591,2482,186.76
2023-01-23,2022-10-11,184,604775,2421,182.17
2023-01-23,2022-10-12,166,604941,2373,178.56
2023-01-23,2022-10-13,159,605100,2331,175.4
2023-01-23,2022-10-14,159,605259,2277,171.33
2023-01-23,2022-10-15,114,605373,2283,171.79
2023-01-23,2022-10-16,68,605441,2257,169.83
2023-01-23,2022-10-17,223,605664,2276,171.26
2023-01-23,2022-10-18,196,605860,2231,167.87
2023-01-23,2022-10-19,167,606027,2196,165.24
2023-01-23,2022-10-20,151,606178,2157,162.31
2023-01-23,2022-10-21,144,606322,2109,158.69
2023-01-23,2022-10-22,118,606440,2132,160.42
2023-01-23,2022-10-23,55,606495,2116,159.22
2023-01-23,2022-10-24,183,606678,2087,157.04
2023-01-23,2022-10-25,126,606804,2029,152.67
2023-01-23,2022-10-26,111,606915,1974,148.54
2023-01-23,2022-10-27,130,607045,1945,146.35
2023-01-23,2022-10-28,85,607130,1871,140.79
2023-01-23,2022-10-29,53,607183,1810,136.2
2023-01-23,2022-10-30,42,607225,1784,134.24
2023-01-23,2022-10-31,116,607341,1677,126.19
2023-01-23,2022-11-01,81,607422,1562,117.53
2023-01-23,2022-11-02,114,607536,1509,113.55
2023-01-23,2022-11-03,76,607612,1434,107.9
2023-01-23,2022-11-04,86,607698,1376,103.54
2023-01-23,2022-11-05,37,607735,1295,97.44
2023-01-23,2022-11-06,43,607778,1283,96.54
2023-01-23,2022-11-07,111,607889,1211,91.12
2023-01-23,2022-11-08,83,607972,1168,87.89
2023-01-23,2022-11-09,83,608055,1140,85.78
2023-01-23,2022-11-10,81,608136,1091,82.09
2023-01-23,2022-11-11,58,608194,1064,80.06
2023-01-23,2022-11-12,37,608231,1048,78.86
2023-01-23,2022-11-13,37,608268,1043,78.48
2023-01-23,2022-11-14,108,608376,1035,77.88
2023-01-23,2022-11-15,83,608459,1037,78.03
2023-01-23,2022-11-16,92,608551,1015,76.37
2023-01-23,2022-11-17,71,608622,1010,76
2023-01-23,2022-11-18,72,608694,996,74.94
2023-01-23,2022-11-19,39,608733,998,75.1
2023-01-23,2022-11-20,26,608759,981,73.82
2023-01-23,2022-11-21,85,608844,955,71.86
2023-01-23,2022-11-22,87,608931,959,72.16
2023-01-23,2022-11-23,71,609002,947,71.26
2023-01-23,2022-11-24,74,609076,940,70.73
2023-01-23,2022-11-25,79,609155,961,72.31
2023-01-23,2022-11-26,34,609189,958,72.09
2023-01-23,2022-11-27,44,609233,965,72.61
2023-01-23,2022-11-28,114,609347,971,73.06
2023-01-23,2022-11-29,88,609435,976,73.44
2023-01-23,2022-11-30,76,609511,960,72.24
2023-01-23,2022-12-01,73,609584,962,72.39
2023-01-23,2022-12-02,96,609680,986,74.19
2023-01-23,2022-12-03,43,609723,990,74.49
2023-01-23,2022-12-04,46,609769,1010,76
2023-01-23,2022-12-05,110,609879,1035,77.88
2023-01-23,2022-12-06,111,609990,1059,79.69
2023-01-23,2022-12-07,109,610099,1097,82.54
2023-01-23,2022-12-08,104,610203,1127,84.8
2023-01-23,2022-12-09,89,610292,1137,85.55
2023-01-23,2022-12-10,46,610338,1149,86.46
2023-01-23,2022-12-11,53,610391,1158,87.13
2023-01-23,2022-12-12,139,610530,1183,89.02
2023-01-23,2022-12-13,138,610668,1233,92.78
2023-01-23,2022-12-14,152,610820,1309,98.5
2023-01-23,2022-12-15,156,610976,1392,104.74
2023-01-23,2022-12-16,133,611109,1429,107.53
2023-01-23,2022-12-17,45,611154,1431,107.68
2023-01-23,2022-12-18,56,611210,1441,108.43
2023-01-23,2022-12-19,140,611350,1471,110.69
2023-01-23,2022-12-20,135,611485,1495,112.49
2023-01-23,2022-12-21,100,611585,1486,111.82
2023-01-23,2022-12-22,102,611687,1484,111.66
2023-01-23,2022-12-23,89,611776,1484,111.66
2023-01-23,2022-12-24,69,611845,1507,113.4
2023-01-23,2022-12-25,46,611891,1500,112.87
2023-01-23,2022-12-26,48,611939,1409,106.02
2023-01-23,2022-12-27,130,612069,1401,105.42
2023-01-23,2022-12-28,106,612175,1355,101.96
2023-01-23,2022-12-29,78,612253,1277,96.09
2023-01-23,2022-12-30,80,612333,1224,92.1
2023-01-23,2022-12-31,44,612377,1223,92.03
2023-01-23,2023-01-01,55,612432,1222,91.95
2023-01-23,2023-01-02,74,612506,1156,86.98
2023-01-23,2023-01-03,67,612573,1088,81.87
2023-01-23,2023-01-04,87,612660,1075,80.89
2023-01-23,2023-01-05,55,612715,1028,77.35
2023-01-23,2023-01-06,54,612769,993,74.72
2023-01-23,2023-01-07,28,612797,952,71.63
2023-01-23,2023-01-08,32,612829,938,70.58
2023-01-23,2023-01-09,72,612901,962,72.39
2023-01-23,2023-01-10,63,612964,895,67.35
2023-01-23,2023-01-11,67,613031,856,64.41
2023-01-23,2023-01-12,67,613098,845,63.58
2023-01-23,2023-01-13,51,613149,816,61.4
2023-01-23,2023-01-14,24,613173,796,59.9
2023-01-23,2023-01-15,33,613206,774,58.24
2023-01-23,2023-01-16,67,613273,767,57.71
2023-01-23,2023-01-17,49,613322,749,56.36
2023-01-23,2023-01-18,47,613369,709,53.35
2023-01-23,2023-01-19,55,613424,709,53.35
2023-01-23,2023-01-20,46,613470,701,52.75
2023-01-23,2023-01-21,15,613485,688,51.77
2023-01-23,2023-01-22,22,613507,678,51.02
2023-01-23,2023-01-23,78,613585,684,51.47
